3,3'-diiodothyronine	(I)2-T4
3,3'-diiodothyronine 4-sulfate	(I)2-T4-SO4
3,5,3'-triiodothyronine	(I)3-T4
3,5,3'-triiodothyronine 4-sulfate	(I)3-T4-SO4
10-formyltetrahydrofolate	10-fthp
11,12-EET	11,12EET
13(S')-hydroxyoctadecadienoic acid	13-HODE
14,15-EET	14,15EET
19-hydroxyprostaglandin H2	19-OH PGH2
2-oxobutanoate	2-Ketobutyrate
12-hydroxy-5,8,11,14-eicosatetraenoic acid	20-HETE
20-OH-leukotriene B4	20HLTB4
22beta-hydroxyCHOLesterol	22HCHOL
24-hydroxyCHOLesterol	24HCHOL
25-hydroxyCHOLesterol	25HCHOL
27-hydroxyCHOLesterol	27HCHOL
27-hydroxyCHOLesterol 3-sulfate	27HCHOL-SO4
2-Arachidonoylglycerol	2AG
2-acylglycerols	2AGs
2-Aminomuconate	2AM
2-Aminomuconate semialdehyde	2AMA
L-2-Aminoadipate	2AMA
L-2-Aminoadipate 6-semialdehyde	2AMAS
2-Chloroethylene oxide	2CEO
(R)-2-hydroxyglutarate	2HG
(S)-2-hydroxyglutarate	2HG
2-oxoglutarate	2OG
2-oxoglutaramic acid	2OGA
2-Phospho-D-glycerate	2PG
(R)-3-aminoisobutyric acid	3AIB
3-Dehydroquinate	3DHQ
3-Dehydroshikimate	3DHSK
3-Hydroxyanthranilate	3HAA
(S)-3-Hydroxybutanoyl-CoA	3HB-CoA
3-methyleneindolenine	3MEIN
3-Phospho-D-glycerate	3PG
2-Hydroxyphytanoyl-CoA	3S2HPhy-CoA
4-(4-(dimethylamino)styryl)-N-methylpyridinium	4-Di-2-ASP
4-hydroxyestradiol-17beta	4-OH-Estradiol
4,8,12-trimethyltridecanoyl-CoA	4,8,12-TMTD-CoA
4-Fumarylacetoacetate	4FAA
4-Maleylacetoacetate	4MAA
5-Hydroxytryptamine	5HT
Serotonin	5HT
5-hydroxytryptamine N-methyl conjugate	5HT-N-CH3
5-hydroxytryptophan	5HTP
5-hydroxyuracil	5OHU
6beta-hydroxytestosterone	6BHT
6-Methylmercaptopurine	6MMP
6-Mercaptopurine	6MP
7-methylguanosine 5'-diphosphate	7-MeGDP
7-methylguanosine 5'-monophosphate	7-MeGMP
7-dehydroCHOLesterol	7DHCHOL
7 alpha-hydroxyCHOLesterol	7HCHOL
8,11,14-Eicosatrienoic acid	8,11,14ETA
8,9-EET	8,9-EET
9-cis-retinoic acid	9cisRA
9(S')-HODE	9S-HODE
arachidic acid	AA
Arachidonate	AA
2-acetylaminofluorene-N-sulfate	AAFNS
4-aminobenzoate	ABENZ
4-Aminobiphenyl	ABPH
Acetyl-CoA	Ac-CoA
N-acetyl-5-hydroxytryptamine	Ac5HT
Acetoacetate	ACA
acetoacetyl-CoA	ACA-CoA
Acetaminophen	ACAP
Acetaminophen (Paracetamol, TN TYLENOL)	ACAP
Acetaminophen glutathione conjugate	ACAP-GSH
Acetaminophen O-glucuronide	ACAP-OGLU
Acetaminophen O-sulfate conjugate	ACAP-SO4
Acetylcarnitine	ACAR
O-acetylCHOLine	AcCho
N-Acetyl-D-glucosamine 1-phosphate	AcGlcN1P
N-Acetyl-D-glucosamine 6-phosphate	AcGlcN6P
2-Amino-3-carboxymuconate semialdehyde	ACS
O-acetylserine	AcSer
Pioglitazone	Actos
Acyclovir	ACV
adenine	Ade
adenosine	Ade-Rib
4-Androstene-3, 17-dione	ADION
Adrenaline	ADR
adenylosuccinate	ADS
Anandamide	AEA
Aflatoxin exo-8,9-oxide	AFBO
Aflatoxin exo-8,9-oxide glutathione conjugate	AFBO-SG
5-acetylamino-6-formylamino-3-methyluracil	AFMU
Aflatoxin B1	AFTB1
Agmatine	AGM
AICAR	AICAR
AIR	AIR
alpha-Linolenic acid	ALA
Ala-tRNA(Ala)	Ala-tRNA(Ala)
Aldosterone	ALDO
adenosine 5'-monophosphate	AMP
acetophenone	APN
acetophenone-mercapturic acid	APN-MTA
acetophenone-mycothiol conjugate	APN-MYT
3-aminopropanal	APrOH
Adenosine 5'-phosphosulfate	APS
arachidonic acid	ARA
4-aminosalicylate	ASAL
Asbestos	Asb
Aspartame	ASP
All-trans-retinoic acid	atRA
all-trans-retinal	atRAL
all-trans-retinol	atROL
beta-Alanine	b-Ala
Beta-carotene	b-CARO
Bilirubin diglucuronide	BDG
Benzoic acid	BENZA
betaine	BET
Benzoyl-CoA thioester	BEZ-CoA
Beta-hydroxybutyrate	bHBA
D-beta hydroxybutyrate	bHBA
beta-hydroxyisobutyryl-CoA	bHIB-CoA
beta-hydroxyisobutyrate	bHIBA
beta-hydroxy-beta-methylglutaryl-CoA	bHMG-CoA
Bilirubin	BIL
beta-methylcrotonyl-CoA	bMC-CoA
beta-methylglutaconyl-CoA	bMC-CoA
2-mercaptoethanol	BME
Bilirubin monoglucuronide	BMG
Benzo(a)pyrene-7,8-diol-glutathione conjugate	BPD-SG
Benzo(a)pyrene-7,8-diol 9,10-epoxide	BPDE
Bromide	Br-
bromosulphophthalein	BSP
Butanoyl-CoA	BT-CoA
Biotin	BTN
Butyrate	BUT
biliverdin	BV
Hexacosanoyl-CoA	C26:0 CoA
Ethylene	C2H4
Benzene	C6H6
Calcium	Ca2+
Caffeine	CAF
CAIR	CAIR
3',5'-Cyclic AMP	cAMP
carbamoyl phosphate	CAP
Carnitine	CAR
CHOLate	CCA
CHOLic acid	CCA
Carbon tetrachloride	CCl4
chenodeoxyCHOLoyl-CoA	CDC-CoA
chenodeoxyCHOLate	CDCA
ChenodeoxyCHOLic acid	CDCA
Calcidiol	CDL
Calcitriol	CDL
cytidine 5'-diphosphate	CDP
Ceramide	CERA
3',5'-Cyclic GMP	cGMP
formaldehyde	CH2O
Acetaldehyde	CH3CHO
Acetate	CH3COO-
CHOLesterol esters	CHEST
D-chiro-inositol	CHI
CHOLine	Cho
CHOLoyl-CoA	CHO-CoA
CHOLesterol	CHOL
CHOLesterol sulfate	CHOL-SO4
CHOLine phosphate	ChoP
Chondroitin sulfate	CHS
Cimetidine	CIM
Citrate	CIT
Chloride	Cl-
Clonidine	CLON
Chloroquine	CLQ
CMP	CMP
cytidine 5'-monophosphate	CMP
CMP-sialic acid	CMP-SA
carbon monoxide	CO
Coproporphyrinogen I	COPROI
Coproporphyrinogen III	COPROII
ubiquinone	CoQ
Cortisone	COR
Corticosterone	CORST
Cortisol	CORT
Coumarin	COUM
Cyclophosphamide	CPM
Creatinine	CREAT
Creatine	CRET
Chorismate	CRSM
Calcitroic acid	CTA
Copper	Cu2+
Copper A	CuA
cysteinylglycine	Cys-Gly
cystathionine	CYSTA
cytosine	Cyt
cytidine	Cyt-Rib
D-Alanine	D-Ala
D-Aspartate	D-Asp
D-Serine	D-Ser
D-tryptophan	D-Trp
2'-deoxyadenosine	dA
Dopamine	DA
Deamino-NAD+	DA-NAD+
diaminobutyrate	DAB
5'-Deoxyadenosine	dADE
2'-deoxyadenosine 5'-diphosphate	dADP
1,2-diacylglycerol	DAG
diacylglycerols	DAGs
DAHP(3-)	DAHP(3-)
5-aminolevulinate	dALA
2'-deoxyadenosine 5'-monophosphate	dAMP
desacetylmycothiol	DAMT
Dopamine 3-O-sulfate	DAOS
1,3-diaminopropane	Dap
dATP	dATP
Dolichyl beta-D-glucosyl phosphate	DbGP
2'-deoxycytidine	dC
2'-deoxycytidine 5'-diphosphate	dCDP
2'-deoxycytidine 5'-monophosphate	dCMP
dCMP	dCMP
dCTP	dCTP
Dodecylcarboxylate	DDCX
Decanoyl-CoA	DEC-CoA
decanoic acid	DECA
Desipramine	DESI
desmosterol	DESMO
Dexamethasone	DEXA
Dextromethorphan	DEXM
Dextrorphan	DEXT
2'-deoxyguanosine	dG
2'-deoxyguanosine 5'-diphosphate	dGDP
2'-deoxyguanosine 5'-monophosphate	dGMP
Docosahexaenoic acid	DHA
Dihydroxyacetone phosphate	DHAP
3,4-dihydroxybenzoate	DHBENZ
dihydroceramide	DHCE
20alpha,22beta dihydroxyCHOLesterol	DHCHOL
dehydroepiandrosterone	DHEA
dehydroepiandrosterone sulfate	DHEA-SO4
Dehydroepiandro-sterone sulfate	DHEA-SO4
Dihydrofolate	DHF
3,16-dihydroxypalmitate	DHPALM
5,6-Dihydrothymine	DHT
5-alpha-dihydrotestosterone	DHTEST
5,6-Dihydrouracil	DHU
Dehydroascorbate	DHvitC
2'-deoxyinosine	dI
digoxin	DIGX
2'-deoxyinosine 5'-monophosphate	dIMP
dipyrromethane	DIPY
Diiodotyrosine	DIT
Dimethylallyl pyrophosphate	DMAPP
1-chloro-2,4-dinitrobenzene	DNCB
2,4-dinitrophenyl-S-glutathione	DNP-S-GSH
11-deoxycorticosterone	DOC
DeoxyCHOLic acid	DOCA
DoliCHOL	DOL
Dolichyl diphosphate	DOLDP
Dolichyl phosphate	DOLP
Dolichyl phosphate D-mannose	DOLPM
Dopa	Dopa
Dephospho-CoA	DP-CoA
Docosapentaenoic acid	DPA
2-deoxy-D-ribose 1-phosphate	dRibP
Debrisoquine	DSQ
Debrisoquine O-glucuronide	DSQ-OG
Docosatetraenoic acid	DTTA
2'-deoxyuridine	dU
2'-deoxyuridine 3'-monophosphate	dU3MP
2'-deoxyuridine 5'-monophosphate	dU5MP
2'-deoxyuridine 5'-diphosphate	dUDP
electron	e-
estrone	E1
estrone 3-sulfate	E1S
beta-estradiol	E2
beta-estradiol 3-sulfate	E2-SO4
D-Erythrose 4-phosphate	E4P
Elaidic acid	ELDA
eicosapentaenoic acid	EPA
EPSP(4-)	EPSP(4-)
Ergothioneine	ERGT
Estradiol-17beta	EST17b
Estrogen	ESTG
ethenoadenine	EtAD
Propionate	EtCOO- or C2H5COO-
ethenocytosine	EtCYS
11,14,17-eicosatrienoic acid	ETE
Ethylene oxide	EtO
Ethanol	EtOH
ezetimibe	EZE
fatty acyl CoA	FACoA
Farnesyl pyrophosphate	FAPP
formamidopyrimidine	FAPY
Fatty Acids	FAs
iron (oxidation state not specified)	Fe
Fe++	Fe2+
Fe2+	Fe2+
iron (ferrous)	Fe2+
iron (3+)	Fe3+
iron (ferric)	Fe3+
ferriheme	FeHM
FGAM	FGAM
5-formiminotetrahydrofolate	FITHF
Fluoride	Fl-
fMet-Leu-Phe	FMLP
Flavin mononucleotide	FMN
formylmycothiol	FMYC
Folate	FOLA
Formyl-CoA	FOR-CoA
D-fructose	Fru
D-Fructose 1,6-bisphosphate	Fru(1,6)P2
D-Fructose 1-phosphate	Fru(1)P
D-Fructose 2,6-bisphosphate	Fru(2,6)P2
D-Fructose 6-phosphate	Fru(6)P
Fumarate	FUMA
Glycerol-3-phosphate	G3P
D-Glyceraldehyde	GA
D-Glyceraldehyde 3-phosphate	GA3P
Guanidinoacetate	GAA
Glycosaminoglycan	GAG
D-galactose	Gal
glycoCHOLate	GC
glycochenodeoxyCHOLate	GCDC
GDP-L-fucose	GDP-Fuc
GDP-alpha-D-mannose	GDP-Man
5-L-gamma-glutamyl amino acid	GGAA
gamma-glutamyl-L-cysteine	gGluCys
gamma-glutamyl group	gGLUT
glutaryl-CoA	GL-CoA
gamma-Linolenic acid	GLA
alpha-D-glucose	Glc
D-Glucose 1-phosphate	Glc1P
alpha-D-Glucose 6-phosphate	Glc6P
D-glucosamine 6-phosphate	GlcN6P
GlcNAc-Ins	GlcNAc-Ins
GlcNAc-Ins-P	GlcNAc-Ins-P
glucosaminyl-inositol	GlcNI
Gln-tRNA(Gln)	Gln-tRNA(Gln)
glycine	Gly
L-glycine	Gly
Glycolate	Glycolate
Geranyl pyrophosphate	GPP
Glutathione	GSH
Guanidine	Gu
guanine	Gua
guanosine	Gua-Rib
Hydrogen	H2
sulfite	H2SO3
Heparan 4-sulfate	H4S
Heparan 6-sulfate	H6S
Halothane	HALO
4-hydroxy-all-trans-retinoic acid	HatRA
Hydrogen bromide	HBr
4-hydroxybutyrate	HBUT
Formate	HCOOH
Hydroxycoumarin	HCOU
4-hydroxycyclophosphamide	HCPM
4-hydroxy-9-cis-retinoic acid	HcRA
Homocysteine	HCYS
4-hydroxydebrisoquine	HDBQ
Homogentisate	HGTA
hydrogen iodide	HI
5-Hydroxyindole acetic acid	HIAA
5-hydroxyindole acetaldehyde	HIALD
5-Hydroxyindoleacetaldehyde	HIALD
Hippuric acid	HIPA
Histamine	Hist
Hydroxymethylbilane	HMBL
Nitrate	HNO3
5-hydroxyomeprazole	HOMZ
3-hydroxypalmitate	HPALM
4-Hydroxyphenylacetaldehyde	HPHAC
4-hydroxyphenytoin	HPHT
Heparin	HPIN
4-hydroxy-L-proline	HPRO
6-hydroxypaclitaxel	HPTXL
Heparan 4,6-disulfate	HSE
3-Hydroxy-N6,N6,N6-trimethyl-L-lysine	HTM-K
4-hydroxytolbutamide	HTOLB
Hyaluronic acid	HUA
Hexanoyl-CoA	HX-CoA
Hexanoate	HXA
hexadecanal	HXAL
1-hexadecylglycerol-3-phosphate	HXDG3P
Hexadecanol	HXOL
hypoxanthine	Hyp
Iodide	I-
1D-myo-Inositol 1,3,4,5,6-pentakisphosphate	I(1,3,4,5,6)P5
1D-myo-inositol 1,3,4,5-tetrakisphosphate	I(1,3,4,5)P4
1D-myo-inositol 1,3,4,6-tetrakisphosphate	I(1,3,4,6)P4
1D-myo-inositol 1,3,4-trisphosphate	I(1,3,4)P3
1D-myo-Inositol 1,4,5-trisphosphate	I(1,4,5)P3
1D-myo-inositol 3,4,5,6-tetrakisphosphate	I(3,4,5,6)P4
1L-myo-Inositol-1-phosphate	I1P
Iodine	I2
Imipramine	IMIP
Imiquimod	IMIQ
IMP	IMP
inosine 5'-monophosphate	IMP
Indole	INDOL
inosine	Ino
Inositol	Ins
delta3-isopentenyl pyrophosphate	IPPP
isobutyryl-CoA	ISB-CoA
Isocaproic aldehyde	ISCAL
Isocitrate	ISCIT
Isoniazid	ISNZ
Isoprotenerol	ISPOL
isovaleryl-CoA	ISV-CoA
Potassium	K+
alpha-ketoisocaproate	KIC
alpha-ketoisovalerate	KIV
alpha-keto-beta-methylvalerate	KMVA
kynurenic acid	KYNA
L-Alanine	L-Ala
L-Arginine	L-Arg
L-Asparagine	L-Asn
L-Aspartate	L-Asp
L-Citrulline	L-Cit
L-cysteine	L-Cys
L-Cystine	L-Cyst
L-Glutamine	L-Gln
L-Glutamate	L-Glu
L-Glutamate 5-semialdehyde	L-Glu5S
L-Histidine	L-His
L-Isoleucine	L-Ile
L-Kynurenine	L-KYN
L-Leucine	L-Leu
L-Lysine	L-Lys
L-Methionine	L-Met
L-methylmalonyl-CoA	L-MM-CoA
L-Ornithine	L-Orn
L-Phenylalanine	L-Phe
L-Proline	L-Pro
L-serine	L-Ser
L-Threonine	L-Thr
L-Tryptophan	L-Trp
L-Tyrosine	L-Tyr
L-Valine	L-Val
lactose	Lac
(S)-Lactate	LACT
Lauroyl-CoA	LAU-CoA
long-chain fatty acids	LCFA
lithoCHOLate	LCHA
LithoCHOLic acid	LCHA
lithoCHOLate sulfate	LCHAS
lignoceric acid	LGCA
Li+	Li+
linoleoyl-CoA	LIN-CoA
linoleic acid	LINA
Lipoate	LIPA
Lipoamide	LIPAM
lanosterol	LNSOL
Omeprazole	Losec
Loperamide	LPAM
2-lysophosphatidylchoLine	LPC
Leukotriene A4	LTA4
Leukotriene B4	LTB4
Leukotriene C4	LTC4
Leukotriene D4	LTD4
Leukotriene E4	LTE4
Lipoxin A4	LXA4
3-Methyladenine	MADE
(S)-Malate	MAL
maltose	Mal
D-mannose	Man
D-Mannose 1-phosphate	Man1P
D-Mannose 6-phosphate	Man6P
beta-D-mannosyldiacetylchitobiosyldiphosphodolichol	MDCDD
MDP	MDP
D-methylmalonyl-CoA	MEMA-CoA
4-methylpentan-1-ol	MePeOH
Magnesium	Mg2+
Mg++	Mg2+
3-methylindole	MIND
Monoiodotyrosine	MIT
Melatonin	MLT
S-methyl-2-mercaptoethanol	MMETOH
Manganese	Mn2+
Mn2+	Mn2+
MoCo	MoCo
molybdate(2-)	MoO4(2-)
2-Methyl-3-oxopropanoate	MOPP
N-methylpyridinium ion	MP+
1-methyl-4-phenyl-pyridinium	MPP
Molybdopterin	MPT
mycothiol	MSH
mycothione	MSSM
S-methylthio adenosine	MTAD
Metformin	MTF
5-methyltetrahydrofolate	MTHF
5,10-methylenetetrahydrofolate polyglutamate	MTHFPG
5-methyltetrahydrofolate polyglutamate	MTHFPG
Methimazole	MTZ
Methimazole S-oxide	MTZ-SOX
Mevalonate	MVA
Mevalonate-5-phosphate	MVA5P
Mevalonate-5-pyrophosphate	MVA5PP
myristoyl-CoA	MYS-CoA
Myristic acid	MYSA
N-Formyl-GAR	N-Formyl-GAR
N,N'-diacetylchitobiosyldiphosphodoliCHOL	N1MNA
N-1-methylnicotinamide	N1MNA
sodium ion	Na+
N-Acetylbenzoquinoneimine	NABQI
N-Acetyl-L-glutamate	NAcGlu
N-acetylisoniazid	NAcISNZ
N-acetyl-p-aminobenzoate	NAcPAB
N-acetyl-p-aminosalicylate	NAcPAS
Noradrenaline	NAd
N-arachidonyl glycine	NAGLY
Nicotinamide	NAM
N-acetylspermidine	NASPM
N-acetylspermine	NASPN
Nicotinate	NCA
NECML	NECML
N-ethylsuccinimide	NETSU
Formylkynurenine	NFK
N-glycoprotein	NGP
N-hydroxy-2-acetylaminofluorene	NH2AAF
N-Hydroxy-4-aminobiphenyl	NHABP
Nitric oxide	NO
Oxygen	O2
Oxaloacetate	OA
9-O-acetylneuraminic acid	OANA-
oxidized glutathione	OGSH
8-oxoguanine	OGUA
Oleic acid	OLEA
5-oxoproline	OPRO-
3-oxopropanoate	OPROP
Oxalate	OX
Progesterone	P4
1,2-diacyl-glycerol 3-phosphate	PA
PAF	PAF
p-aminohippurate	pAHP
Palmitate	Palm
palmitic acid	Palm
palmitoyl-CoA	PalmCoA
Pantothenate	PanK
PAP [adenosine 3',5'-bismonophosphate]	PAP
PAPS 3'-phospho-5'-adenylyl sulfate]	PAPS
PAPS	PAPS
Pb++	Pb2+
Phosphatidyl CHOLine	PC
PhosphoCHOLine	PCho
Phosphocreatine	Pcr
phosphatidylCHOLines	PCs
6-Phospho-D-gluconate	PDG
Pyridoxine	PDX
Pyridoxine phosphate	PDXP
phosphatidylethanolamine	PE
2-Phenylethylamine	PEA
Phosphoenolpyruvate	PEP
phosphoethanolamine	PETA
Prostaglandin D2	PGD2
Prostaglandin E1	PGE1
Prostaglandin E2	PGE2
Prostaglandin F2alpha	PGF2a
Prostaglandin F2-alpha	PGF2a
Prostaglandin G2	PGG2
Prostaglandin H2	PGH2
Prostacyclin	PGI2
Phenol	PhOH
Orthophosphate	Pi
Phosphatidylinositol-3,4,5-trisphosphate	PI(3,4,5)P3
Phosphatidylinositol-4,5-bisphosphate	PI(4,5)P2
phospholipids	PL
Palmitoleic acid	Pmoa
4' phosphopantetheine	PPANT
pyrophosphate	PPi
PQQ [pyrroloquinoline quinone]	PQQ
5-phosphoribosylamine	PRA
pregnenolone	PREG
pregnenolone sulfate	PREGS
5-phosphoribosylglycinamide	PRGA
PRPP	PRPP
phosphatidylserine	PS
Paclitaxel	PTXL
Pyridoxamine	PXA
Pyridoxamine phosphate	PXAP
Pyridoxal	PXL
Pyridoxal phosphate	PXLP
Pyridine	PY
Pyruvate	PYR
q-dihydrobiopterin	qDHB
ubiquinol	QH2
quinine	QN
Quinidine	QND
Quinolinate	QUIN
D-ribose 1-phosphate	R1P
D-ribose 5-phosphate	R5P
Rosiglitazone	RGZ
Riboflavin	RIB
Retinyl palmitate	RPALM
D-Ribulose 5-phosphate	RU5P
sulfur	S
sulfide	S(2-)
sulfide (2-)	S(2-)
Sphingosine-1-phosphate	S1P
sialic acid	SA
Saccharin	SACC
saccharopine	SACN
S-adenosylhomocysteine	SAH
SAICAR	SAICAR
Salicylate	SAL
S-adenosylmethionine	SAM
S-Adenosylmethioninamine	SAMA
Sulfanilamide	SAMD
semidehydroascorbate	SHAS
Silicon dioxide	SiO2
Shikimate	SKM
Shikimate 3-phosphate	SKMP
inorganic sulfate	SO4(2-)
sulfate	SO4(2-)
D-sorbitol 6-phosphate	Sor6P
sphinganine	SPA
sphinganine 1-phosphate	SPAP
sphingosine	SPG
Sphingomyelin	SPHM
sphingomyelins	SPHM
Spermidine	SPM
Spermine	SPN
Squalene	SQE
Squalene 2,3 epoxide	SQEO
siroheme	SRHM
stearoyl-CoA	ST-CoA
stearate	STEA
stearic acid	STEA
Salicyluric acid	SUA
sucrose	Suc
Succinyl-CoA	SUCC-CoA
Succinate	SUCCA
succinate semialdehyde	SUCCSA
Sugar phosphate	SUGP
Thyroxine	T4
triacylglycerol	TAG
triacylglycerols	TAGs
Tamoxifen	TAM
Tamoxifen N-glucuronide	TAMNG
Tamoxifen N-oxide	TAMO
taurine	TAU
Tolbutamide	TBM
tauroCHOLate	TCA
taurochenodeoxyCHOLate	TCCA
Thiamin diphosphate	TDP
thymidine 5'-diphosphate	TDP
4-Trimethylammoniobutanal	TEABL
4-Trimethylammoniobutanoate	TEABT
Testosterone	TES
Trifluoroacetylchloride	TFAC
Tetrahydrobiopterin	THBP
Tetrahydrofolate	THF
Thiamin	THMN
thymine	Thy
thymidine	Thy-dRib
taurolithoCHOLate	TLCA
taurolithoCHOLate sulfate	TLCAS
Trimethylamine	TMA
Tetramethylammonium	TMAM
Trimethyamine N-oxide	TMAO
thymidine 5'-monophosphate	TMP
TMP thymidine 5'-monophosphate	TMP
Thiamin pyrophosphate	TPP
Thiamin triphosphate	TTP
TTP thymidine 5'-triphosphate	TTP
Thromboxane A2	TXA2
Tyramine	TYR
uridine 2'-monophosphate	U2MP
uridine 3'-monophosphate	U3MP
uridine 5'-diphosphate	U5DP
uridine 5'-monophosphate	U5MP
Urocanate	UCA
UDP	UDP
UDP-N-acetyl-D-glucosamine	UDP-AcGlcN
UDP-D-galactose	UDP-Gal
UDP-glucuronic acid	UDP-GCU
UDP-glucose	UDP-Glc
UDP-xylose	UDP-Xyl
3-ureidoisobutyric acid	UIBA
UMP	UMP
3-Ureidopropionate	UPROP
uracil	Ura
uridine	Ura-Rib
Uroporphyrinogen I	URO1
Uroporphyrinogen III	URO3
UTP uridine 5'-triphosphate	UTP
Pentanoate	Valerate
Vinyl chloride	VC
Vitamin D3	VD3
Cobamide coenzyme	VitB12 coenzyme
Niacin	VitB3
Ascorbate	VitC
1,25-dihydroxyvitamin D3	vitD3(OH)2
1,24,25-trihydroxyvitamin D3	vitD3(OH)3
vitamin K hydroquinone	VKHQ
vitamin K epoxide	VKO
Xanthine	XAN
XMP	XMP
D-Xylulose 5-phosphate	XY5P
Zinc 2+ [zinc (2+)]	Zn2+
Zinc 2+	Zn2+
Zn++	Zn2+
zymosterol	ZSOL
